 
NO ./assets/textures/north.xpm    
SO ./assets/textures/west.xpm      
WE ./assets/textures/west.xpm
EA ./assets/textures/west.xpm   


C        10,50,50    
F 255,168,120

111111111111111111111111111111111111111111111111111111111111111111
10000000000000000000000000000000000000000000000000000000000000001
111111111111111110000000000010000000000000000000000000000000000001
100000000000000000000000000010000000000000000000000000000000000001
100000000000000000000000000000000000000000000000000000000000000001
100000000000000000000000000010000000000000000000000000000000000001
1000000000000W000000000000010000000000000000000000000000000000001
100000000000000000000000000010000011111111111111111111111111111111
100000000000000000000000000010000000000000000000000000000000000001
100000000000000000000000000010000000000000000000000000000000000001
100000000000000000000000000100000000000000000000000000000000000011
100000000000000000000000000010000000000000000000000000000000000001
100000000000000000000000000010000000000000000000000000000000000001
111111111111111111111111111111111111111111111111111111111111111111