 
SO ./path_to_the_south_texture        
WE  ./path_to_the_west_texture
NO ./path_to_the_north_texture          
EA ./path_to_the_east_texture    
F  108,150,120     
C 225,30,0


111111
000000
522222
00000
52222
000515
00023020
