 
NO ./assets/    textures/north.xpm    
SO ./assets/textures/west.xpm      
WE ./assets/textures/west.xpm
EA ./assets/textures/west.xpm   


F        168,50,50    
C 50,168,0

111111111111111111111111111111111111111111111111111111111111111111

100000000000000000000000000000000000000000000000000000000000000001
111111111111111110000000000010000000000000000000000000000000000001
100000000000000000000000000010000000000000000000000000000000000001
100000000000000000000000000010000000000000000000000000000000000001
100000000000000000000000000010000000000000000000000000000000000001
100000000000000000000000000010000011111111111111111111111111111111
100000000000000000000000000010000000000000000000000000000000000001
100000000000000000000000000010000000000000000000000000000000000001
100000000000000000000000000010000000000000000000000000000000000001
100000000000000000000000000010000000000000000000000000000000000001
100000000000000000000000000010000000000000000000000000000000000001
111111111111111111111111111111111111111111111111111111111111111111