 
SO ./path_to_the_south_texture        
WE  ./path_to_the_west_texture
NO ./path_to_the_north_texture          
EA ./path_to_the_east_texture    
F  108,150,120     
C 225,30,0


11111
10S001
100001
111111